00000000000000000000
00000111110000000000
00000111110000111100
00000111110000111100
00000111110000111100
00000000000000000000
00000000000000000000
00000000000000011100
00001111100000011100
00001111100000011100
00001111100000000000
00000000000000000000
00000000000000000000
